 (Group 1)

3rabity --> احمد مدحت احمد كامل

Sounds Good --> شريف اشرف عنتر برهام

Residence -- > مورين ماجد ماهر اسكاروس

Bis website --> محمد رمضان رفاعى محمد
  
Spare --> مريم قرشى محمود

Education For All --> علا فايز زكى مهران

(Group 2)

Clinic System --> عبدالعزيز احمد سعد انور

My doctor --> محمود عصام محمد عبدالمجيد

Your Job -- > فاطمة عبدالراضى محمد محمود

WAP System --> افنان خالد حسن محمد

be in home --> جاسنتا ثروت كمال مسدارى

Round Egypt --> يوسف عادل فوزى زارع

(Group 3)

Banking system --> رانيا عادل صالح على

Power pill --> احمد حمدى عطيه يونس

r-s transfer -- > ارسانى وديع حلمى اسحق

Rent It --> جنة وليد عبدالكريم

Students affairs --> مارينا صفوت سعيد فكري

Patient Services --> عبير عبداللاه محمود عبداللطيف

(Group 4)

Sanda --> ارفن عونى لطيف عازر

Ebb --> داليا محمد قاسم عبد الحليم

Smart education -- > امين محمد ماهر عبد العظيم

Smart Home --> ساره عادل صلاح محمود

Help me --> نورهان عزت مصطفى محمود

businessny --> يارا نبيل حنا نظيم

(Group 5)

Missing pill--> ماركو عادل هنرى عزيز

DelMec--> محمد احمد عيد مسعود

Legacy construction -- > عمر محمد فتحى محمد عمر

Hire Me --> فاطمة حسن عبد الله عبد المنعم

Evento --> الزهراء علي حامد إسماعيل

Hotelegy--> مرام عمرو محمد الخازندار



